-1 2 -1 -1  4 -1 -1  2  4  4  2 -1
-1 4 -1 -1  2 -1 -1  4 -1 -1  4 -1
-1 4  2  4  4  2  3  3 -1 -1  5 -1
-1 4 -1 -1  2 -1 -1 -1  4 -1  4 -1
-1 4  2  4  4  2  3 -1  3  4  5 -1
-1 4 -1 -1 -1 -1 -1 -1  2 -1 -1 -1
-1 4 -1 -1 -1 -1 -1 -1  2 -1 -1 -1
-1 4  9 -1 -1 -1 -1 -1  2 -1 -1 -1
-1 4  2  4 -1 -1  4 -1  2 -1 -1 -1
-1 4 -1 -1 -1 -1  2 -1  4 -1 -1 -1
-1 4 -1 -1 -1 -1  2  4  4 -1 -1 -1
-1 4 -1 -1 -1 -1  2 -1 -1 -1 -1 -1
-1 4  2  4  4  2  3  3  4  5  3 -1
-1 4 -1 -1  2 -1  4 -1 -1  4 -1 -1
-1 4 -1 -1  2 -1  4 -1 -1  4 -1 -1
-1 4  2  4  4 -1  2 -1 -1  3 -1 -1
-1 4 -1 -1  2 -1  4 -1 -1  4 -1 -1
-1 4 -1 -1  2  4 -1 -1 -1  4  2 -1
-1 4 -1 -1 -1  2 -1 -1  4  4 -1 -1
-1 4  2  4  4  2 -1 -1 -1  3 -1 -1
-1 4 -1  2 -1 -1 -1 -1 -1  4 -1 -1
-1 4 -1  2  4  4  2  3  3  4 -1 -1
-1 4 -1 -1 -1 -1 -1 -1 -1 -1 -1 -1
-1 4 -1 -1 -1 -1 -1 -1 -1 -1 -1 -1